11111111111111111111111111111111111111111111111111
11111111111111111111111111111111111111111111111111
10000000000000000000000000000000000000000000000001
10000000000000000000000000000000000000000000000001
10000000000000000000011111111101111111111111111111
10000000000000000000011111111101111111111111111111
10000000000000000000011011000000000000000000000001
10000000000000000000011011010000000000000000000001
10000000000000000000011011000000000000000000000001
10000000000000000000011011000000000000000110000001
10000000110001100011011011000000000000000110000001
10000011111111111111111011000000000000010000000001
11010010000010000000011011000000000001100000000001
10000000000000010000111011000000000001100100000001
10000000000000000001110011000000000000000000000001
10000010000100000011100011000000000000000000000001
10000000010000100111000011000000110000000000000001
10000000000000001110000011000000110000000000000001
10000111010000011100000011000000000000000000000001
10000111111111111000000011000000000000000000000001
10000000000000000000000001000000000000000000000001
10000000000000000000000001000000000000000000000001
10000000000000000000001001110000000000000000000001
10000000000000000000001000010000000000000000000001
11111111111111111111111000011111111111111111111001
11111111111111111111111000011111111111111111111001
10000000000000000000001000010100000000000000000001
10010000000000000000001111110010011110000000000001
10000000000111111000000011111110111111000000111111
10000000000111111000001111011110000000000000111101
10000000000111111000000000011110001000000000111101
10000001000111111101000000011110000000010000111101
10000000000011111110000011011110000000100000111101
10000000000001011110000011011110001000000000111101
10001000111100001100000011011110000000000000111101
10000000111100000001000011011110000000000000111101
10000000011000000010000011011110000000000000111101
10100000000000000000000011011110010100100000111101
10000000000010000000000011011111100010110001111101
10000000100000000000100011011111100000111111111101
10111100000001100000000011011110001100100000111101
11111110001100000000000011011110100000000000111101
11000000000000000000000011011110010000000000111101
11010100000000000010000011011111000000000000111101
11000100000010001010000011011111111111111110111101
10000000011000000000110011011111111111111110111101
10000000000100001010010011001101111111111110111101
10010000000000000010000011000000000000000000000001
10001000000000000000000111111111111111111111111111
11111111111111111111111111111111111111111111111111
